#############
#         O #
#   P    ####
#           #
#######     #
#  O        #
#           #
#           #
#           #
#           #
#       XX  #
#           #
#############
